[方案]
方案名称=自定义

[零声母标识]
a=AA
ang=AH
e=EE
eng=EH

[声母]
# 双拼编码就是它本身的声母不必列出
zh=V
ch=U
sh=I

[韵母]
# 双拼编码就是它本身的韵母不必列出
ai=S
an=N
ang=H
ao=C
ong=R
ou=Z
ei=W
en=T
eng=D
er=R
ia=X
ian=M
iang=L
iao=K
ie=Y
in=F
ing=;
iong=R
iu=J
ua=X
uai=B
uan=P
uang=L
ue=G
ui=V
un=Q
uo=O
ve=G

